vos	b o s
nos	n o s
bar	b a rf
gua	G w a
ja	x a
tas	t a s
rus	r u s
tran	t rf a ng
fút	f u+ t
par	p a rf
col	k o l
nen	n e ng
dís	d i+ s
rez	r e s
sig	s i G
mien	m j e ng
fue	f w e
tem	t e m
ras	r a s
cons	k o ng s
roi	r oI
cel	T e l
rey	r eI
doc	d o k
dad	d a
sec	s e k
óp	o+ p
fu	f u
nuel	n w e l
tie	t j e
fí	f i+
tai	t aI
pa	p a
for	f o rf
mer	m e rf
nis	n i s
web	w e b
guas	G w a s
fies	f j e s
diós	d j o+ s
ne	n e
gal	G a l
var	b a rf
fox	f o k s
plen	p l e n
cluir	k l w i rf
nau	n aU
tal	t a l
pe	p e
ven	b e ng
nar	n a rf
vai	b aI
zul	s u l
bla	b l a
cón	k o+ ng
rre	r e
só	s o+
dre	d rf e
gi	x i
vam	b a m
via	b j a
ron	r o ng
tú	t u+
deu	d eU
ñe	n~ e
o	o
lias	l j a s
be	b e
trac	t rf a k
fo	f o
cor	k o rf
gí	x i+
y	j
om	o m
guien	g j e ng
tiem	t j e m
cios	T j o s
lon	l o ng
rin	r i ng
cá	k a+
zinc	T i n k
vión	b j o+ ng
fi	f i
múl	m u+ l
siem	s j e m
cuer	k w e rf
gos	G o s
dio	d j o
yec	j e k
brar	b rf a rf
tud	t u
fra	f rf a
co	k o
mios	m j o s
67	s eI s j e t e
mix	m i s
fe	f e
tria	t rf j a
lan	l a ng
nu	n u
tle	t l e
lle	L e
tá	t a+
tro	t rf o
nio	n j o
dió	d j o+
jos	x o s
noz	n o s
cho	tS o
nom	n o m
ú	u+
cla	k l a
rá	r a+
bá	b a+
prue	p rf w e
nues	n w e s
ñol	n~ o l
che	tS e
rri	r i
nam	n a m
grie	G rf j e
zag	T a G
tec	t e k
rres	r e s
en	e ng
tí	t i+
gis	x i s
sas	s a s
gá	G a+
dar	d a rf
yo	L o
bur	b u rf
blas	b l a s
am	a m
mir	m i rf
ge	x e
plia	p l j a
vuel	b w e l
mó	m o+
léc	l e+ k
fan	f a n
mio	m j o
mé	m e+
pú	p u+
cue	k w e
ciar	T j a rf
mo	m o
vial	b j a l
mil	m i l
ges	x e s
gé	x e+
és	e+ s
rí	r i+
fuen	f w e ng
fia	f j a
flic	f l i k
lim	l i m
ín	i+ n
go	G o
gran	G rf a ng
bis	b i s
sul	s u l
test	t e s t
él	e+ l
gus	G u s
nios	n j o s
cio	T j o
vin	b i ng
mos	m o s
lla	L a
cias	T j a s
ci	T i
ol	o l
gas	G a s
nal	n a l
tón	t o+ ng
oc	o k
fá	f a+
zan	s a ng
ál	a+ l
úl	u+ l
em	e m
no	n o
cra	k rf a
soft	s o f t
mún	m u+ ng
ves	b e s
rás	r a+ s
rril	r i l
dres	d rf e s
flu	f l u
lin	l i ng
ller	L e rf
bia	b j a
bi	b i
is	i s
li	l i
gar	G a rf
nien	n j e ng
cier	s j e rf
df	d f
ins	i ng s
vá	b a+
ces	T e s
ver	b e rf
plio	p l j o
ter	t e rf
jar	x a rf
clau	k l aU
viar	b j a rf
rol	r o l
vas	b a s
rrio	r j o
xis	s i s
sis	s i s
pli	p e e l e i
nia	n j a
77	s j e t j e t e
eu	eU
cer	s e rf
pin	p i n
ce	T e
ni	n i
quier	k j e rf
sub	s u b
to	t o
res	r e s
gun	G u ng
trar	t rf a rf
gún	G u+ ng
ñal	n~ a l
pia	p j a
ral	r a l
den	d e ng
cam	k a m
chim	tS i m
ís	i+ s
tri	t rf i
vil	b i l
lom	l o m
clu	k l u
brien	b rf j e ng
jó	x o+
pres	p rf e s
di	d i
bohi	b o i
pios	p j o s
vic	b i k
diá	d j a+
vis	b i s
drá	d rf a+
blio	b l j o
fec	f e k
fó	f o+
grias	G rf j a s
rés	r e+ s
lua	l w a
n	e n e
téc	t e+ k
rias	r j a s
lec	l e k
me	m e
za	s a
bo	b o
don	d o ng
ya	L a
dul	d u l
cha	tS a
ám	a+ m
tres	t rf e s
bier	b j e rf
rán	r a+ ng
au	aU
té	t e+
pien	p j e ng
gu	G u
bre	b rf e
fran	f rf a ng
mis	m i s
syl	s j l
jun	x u ng
as	a s
guí	g i+
pu	p u
cil	s i l
son	s o ng
zé	s e+
zur	s u rf
puer	p w e rf
ex	e k s
fras	f rf a s
rec	r e k
psi	s i
ñi	n~ i
lud	l u
an	a ng
rial	r j a l
nó	n o+
jus	x u s
tei	t eI
pez	p e T
vel	b e l
pan	p a ng
du	d u
béis	b e+ i s
vec	b e k
án	a+ ng
ri	r i
jil	x i l
nue	n w e
sa	s a
nor	n o rf
bios	b j o s
má	m a+
bras	b rf a s
có	k o+
vier	b j e rf
vo	b o
brin	b rf i ng
dus	d u s
com	k o m
ris	r i s
vio	b j o
jue	x w e
los	l o s
bum	b u m
cul	k u l
pla	p l a
trol	t rf o l
dé	d e+
pren	p rf e ng
ños	n~ o s
0	s e rf o
bus	b u s
pio	p j o
yan	L a ng
plan	p l a ng
por	p o rf
ta	t a
das	d a s
bos	b o s
man	m a ng
nig	n i G
cua	k w a
nú	n u+
cre	k rf e
bién	b j e+ ng
rui	r w i
tró	t rf o+
pre	p rf e
cues	k w e s
tui	t w i
tua	t w a
ben	b e ng
sio	s j o
tor	t o rf
bé	b e+
cial	T j a l
cí	T i+
que	k e
os	o s
drar	d rf a rf
de	d e
til	t i l
gam	G a m
ti	t i
ai	aI
er	e rf
tir	t i rf
llar	L a rf
tos	t o s
sión	s j o+ ng
prác	p rf a+ k
lli	L i
gre	G rf e
gios	x j o s
fes	f e s
tu	t u
fuer	f w e rf
tul	t u l
vien	b j e ng
xi	o ng s e
cli	k l i
tel	t e l
cé	s e+
nel	n e l
ob	o b
car	k a rf
des	d e s
mi	m i
tus	t u s
bra	b rf a
sam	s a m
llos	L o s
ar	a rf
men	m e ng
tur	t u rf
les	l e s
piel	p j e l
ro	r o
duc	d u k
va	b a
cris	k rf i s
do	d o
mex	m e s
truc	t rf u k
cual	k w a l
cal	k a l
gui	g i
ciu	T j u
pun	p u n
mió	m j o+
sua	s w a
oy	oI
tex	t e s
pon	p o ng
red	r e
sai	s aI
xo	s o
drán	d rf a+ ng
jer	x e rf
chi	tS i
ga	G a
ten	t e ng
chos	tS o s
sun	s u ng
tien	t j e ng
ca	k a
jo	x o
ber	b e rf
wan	w a ng
tual	t w a l
ún	u+ ng
ses	s e s
per	p e rf
sen	s e ng
lí	l i+
xe	s e
mú	m u+
cuá	k w a+
vi	b i
su	s u
cio-7	T j o+ j e t e
ted	t e
cin	s i ng
rar	r a rf
clí	k l i+
aun	aU ng
pai	p aI
prés	p rf e+ s
lar	l a rf
cuns	k u n s
fac	f a k
biz	b i s
sés	s e+ s
gri	G rf i
bio	b j o
nan	n a ng
glas	G l a s
cog	k o G
zo	T o
gel	x e l
chas	tS a s
ley	l eI
voy	b oI
pó	p o+
un	u ng
ná	n a+
vez	b e s
van	b a ng
pi	p i
nes	n e s
tras	t rf a s
mes	m e s
pol	p o l
rra	r a
bun	b u ng
sal	s a l
cu	k u
sos	s o s
mu	m u
mium	m j u m
im	i m
miel	m j e l
bú	b u+
cuan	k w a ng
cien	s j e ng
mán	m a+ ng
vir	b i rf
sin	s i ng
lor	l o rf
bli	b l i
ár	a+ rf
sla	z l a
sus	s u s
u	u
lien	l j e ng
fa	f a
tuar	t w a rf
las	l a s
tral	t rf a l
ros	r o s
guir	g i rf
yes	L e s
zum	s u m
dic	d i k
far	f a rf
xión	s j o+ n
bró	b rf o+
fle	f l e
ren	r e n
bren	b rf e ng
gión	x j o+ ng
bón	b o+ ng
zom	T o m
ser	s e rf
ton	t o ng
jor	x o rf
dos	d o s
bol	b o l
né	n e+
llo	L o
lu	l u
cré	k rf e+
cies	s j e s
bir	b i rf
len	l e ng
dor	d o rf
pos	p o s
fer	f e rf
reu	r eU
ju	x u
con	k o ng
sám	s a+ m
trí	t rf i+
tros	t rf o s
le	l e
dop	d o p
cef	T e f
pues	p w e s
gan	G a ng
san	s a ng
grá	G rf a+
vul	b u l
tia	t j a
ré	r e+
pie	p j e
sor	s o rf
et	e t
mun	m u ng
sí	s i+
yor	L o rf
bros	b rf o s
bal	b a l
bó	b o+
cir	s i rf
cie	s j e
ma	m a
nit	n i t
gla	G l a
zón	s o+ ng
quer	k e rf
bue	b w e
op	o p
e	e
la	l a
zu	s u
bor	b o rf
mus	m u s
cro	k rf o
sil	s i l
quí	k i+
bes	b e s
zar	s a rf
muy	m u j
diz	d i s
ní	n i+
sar	s a rf
guel	g e l
cinc	T i n k
zas	s a s
ño	n~ o
trín	t rf i+ ng
ve	b e
cep	T e p
bri	b rf i
ger	x e rf
som	s o m
pri	p rf i
der	d e rf
llas	L a s
ir	i rf
nir	n i rf
lum	l u m
gen	x e ng
gue	g e
bac	b a k
glés	G l e+ s
cen	s e ng
ner	n e rf
post	p o s t
dia	d j a
jem	x e m
ria	r j a
fri	f rf i
char	tS a rf
rió	r j o+
jes	x e s
tios	t j o s
rio	r j o
plo	p l o
moi	m oI
nuo	n w o
ques	k e s
llan	L a ng
tam	t a m
pro	p rf o
zig	s i G
dum	d u m
el	e l
ban	b a ng
rie	r j e
lia	l j a
ña	n~ a
tan	t a ng
del	d e l
pul	p u l
ret	r e t
cuál	k w a+ l
jas	x a s
sá	s a+
ró	r o+
fen	f e n
lo	l o
tar	t a rf
dro	d rf o
tes	t e s
pel	p e l
mas	m a s
buz	b u T
tra	t rf a
rren	r e ng
dios	d j o s
az	a s
bien	b j e ng
rro	r o
ble	b l e
fun	f u ng
jez	x e s
gru	x e e rf e u
sol	s o l
bai	b aI
miem	m j e m
dria	d rf j a
cos	k o s
tó	t o+
drés	d rf e+ s
é	e+
más	m a+ s
crí	k rf i+
vés	b e+ s
chu	tS u
ba	b a
ra	r a
can	k a ng
cas	k a s
mí	m i+
us	u e s e
cuen	k w e ng
sim	s i m
te	t e
nas	n a s
ac	a k
al	a l
cár	k a+ rf
diar	d j a rf
fre	f rf e
paz	p a T
pas	p a s
mal	m a l
qué	k e+
yen	L e ng
or	o rf
quie	k j e
da	d a
ier	j e rf
pen	p e ng
quis	k i s
tio	t j o
se	s e
cau	k aU
fus	f u s
fom	f o m
pal	p a l
cun	k u n
tión	t j o+ ng
pue	p w e
prin	p rf i ng
dian	d j a ng
ran	r a ng
si	s i
ción	s j o+ ng
tad	t a
ples	p l e s
po	p o
dí	d i+
net	n e t
qui	k i
miér	m j e+ rf
a	a
pá	p a+
i	i
bom	b o m
ple	p l e
rios	r j o s
fon	f o n
ñas	n~ a s
re	r e
chor	tS o rf
lín	l i+ ng
nión	n j o+ ng
lis	l i s
so	s o
cia	s j a
á	a+
die	d j e
dis	d i s
bro	b rf o
tac	t a k
es	e s
dan	d a ng
ló	l o+
dien	d j e ng
mar	m a rf
yu	L u
ur	u rf
by	b aI
on	o ng
gual	G w a l
gro	G rf o
na	n a
cur	k u rf
bas	b a s
mues	m w e s
cri	k rf i
zi	T i
click	k l i k k
ze	s e
ad	a
lles	L e s
lam	l a m
guay	G w aI
bu	b u
ru	r u
nun	n u ng
llí	L i+
in	i ng
drón	d rf o+ ng
bru	b rf u
pec	p e k
gra	G rf a
ór	o+ rf
je	x e
crip	k rf i p
rior	r j o rf
tre	t rf e
dra	d rf a
